u1,0,2,0
u2,0,4,4
u3,0,3,2
u4,0,3,3
u5,0,4,3
u6,0,1,3
u7,0,3,2
u8,0,0,3
u9,0,1,4
u10,0,4,2
u1,1,4,3
u2,1,4,4
u3,1,3,2
u4,1,2,4
u5,1,0,0
u6,1,4,2
u7,1,2,0
u8,1,4,4
u9,1,4,1
u10,1,0,1
u1,2,4,1
u2,2,1,3
u3,2,4,4
u4,2,1,1
u5,2,3,1
u6,2,3,4
u7,2,4,2
u8,2,1,2
u9,2,2,0
u10,2,3,3
u1,3,3,4
u2,3,2,1
u3,3,4,0
u4,3,4,2
u5,3,1,3
u6,3,2,1
u7,3,1,1
u8,3,4,4
u9,3,2,0
u10,3,0,4
u1,4,0,1
u2,4,4,3
u3,4,3,2
u4,4,3,3
u5,4,2,0
u6,4,0,1
u7,4,3,0
u8,4,0,4
u9,4,3,4
u10,4,4,1
u1,5,2,0
u2,5,3,2
u3,5,1,0
u4,5,0,3
u5,5,4,2
u6,5,2,0
u7,5,0,3
u8,5,1,2
u9,5,3,2
u10,5,0,2
u1,6,0,1
u2,6,4,4
u3,6,2,3
u4,6,4,3
u5,6,2,0
u6,6,0,4
u7,6,4,0
u8,6,0,4
u9,6,0,3
u10,6,1,2
u1,7,1,2
u2,7,1,2
u3,7,4,3
u4,7,3,4
u5,7,4,1
u6,7,0,1
u7,7,0,2
u8,7,4,1
u9,7,2,4
u10,7,1,1
u1,8,4,2
u2,8,1,2
u3,8,1,2
u4,8,4,1
u5,8,1,2
u6,8,0,3
u7,8,0,3
u8,8,4,4
u9,8,1,0
u10,8,2,3
u1,9,4,2
u2,9,4,4
u3,9,2,1
u4,9,0,3
u5,9,2,0
u6,9,4,2
u7,9,0,3
u8,9,1,1
u9,9,0,2
u10,9,4,2
