u1,0,2,0
u2,0,4,4
u3,0,3,2
u4,0,3,3
u5,0,4,3
u6,0,1,3
u7,0,3,2
u8,0,0,3
u9,0,1,4
u10,0,4,2
u1,1,4,3
u2,1,4,4
u3,1,3,2
u4,1,2,4
u5,1,0,0
u6,1,4,2
u7,1,2,0
u8,1,4,4
u9,1,4,1
u10,1,0,1
u1,2,4,1
u2,2,1,3
u3,2,4,4
u4,2,1,1
u5,2,3,1
u6,2,3,4
u7,2,4,2
u8,2,1,2
u9,2,2,0
u10,2,3,3
u1,3,3,4
u2,3,2,1
u3,3,4,0
u4,3,4,2
u5,3,1,3
u6,3,2,1
u7,3,1,1
u8,3,4,4
u9,3,2,0
u10,3,0,4
u1,4,0,1
u2,4,4,3
u3,4,3,2
u4,4,3,3
u5,4,2,0
u6,4,0,1
u7,4,3,0
u8,4,0,3
u9,4,0,1
u10,4,4,1