u1,0,0,1
u2,0,2,0
u3,0,3,0
u4,0,4,0
u5,0,4,0
u1,1,3,0
u2,1,1,0
u3,1,3,1
u4,1,0,4
u5,1,2,4
u1,2,2,3
u2,2,1,2
u3,2,3,2
u4,2,0,2
u5,2,1,2
u1,3,1,4
u2,3,4,3
u3,3,1,3
u4,3,0,0
u5,3,1,2
u1,4,2,4
u2,4,3,1
u3,4,1,2
u4,4,2,4
u5,4,3,4
u1,5,1,4
u2,5,4,3
u3,5,4,4
u4,5,4,3
u5,5,3,3
u1,6,0,2
u2,6,0,0
u3,6,0,3
u4,6,0,1
u5,6,2,4
u1,7,2,4
u2,7,2,3
u3,7,0,3
u4,7,3,0
u5,7,3,1
u1,8,3,3
u2,8,2,3
u3,8,1,2
u4,8,4,0
u5,8,1,1
u1,9,4,4
u2,9,2,4
u3,9,3,4
u4,9,3,3
u5,9,4,3